wwwwwwwwwwwwwwwwwwwwwwwwww
w----x-----A-------------w
w--------------------x---w
wx-----------------------w
w---------------x--------w
w-------x----------------w
w------------------x-----w
w------------------------w
w-x----------------------w
w----------x-------------w
w-------------------x----w
wx-----------------------w
wwwwwwwwwwwwwwwwwwwwwwwwww